AAlegriaEstaNoCoracao	A alegria está no coração
ABencao	A Bênção
AbraMeusOlhos	Abra Meus Olhos
AbraOCoracao	Abra o Coração
AbreOsOlhosDoMeuCoracao	Abre Os Olhos do Meu Coração
ACadaDia	A cada dia
AcendeOFogoEmMim	Acende o Fogo Em Mim
AclameAoSenhor	Aclame ao Senhor
AComecarEmMim	A começar em mim
Acredito	Acredito
ADiferencaECristo	A diferença é Cristo
Adoramos	Adoramos
AdoramosOCordeiro	Adoramos o Cordeiro
AdorarADeus	Adorar a Deus
AEleAGloria	A Ele a glória
AEleAGloria	A Ele a glória
AgnusDei	Agnus Dei
AguaCristalina	Água Cristalina
AguasPurificadoras	Águas purificadoras
AindaQueAFigueira	Ainda que a figueira
Alegria	Alegria
ALeiDoSenhor	A Lei do Senhor
Aleluia	Aleluia
AleluiaSalvacaoEGloria	Aleluia, salvação e glória
AlfaEOmega	Alfa e ômega
AlfaEOmega	Alfa e ômega
Alianca	Aliança
AlmaAbatida	Alma Abatida
AlmaCansada	Alma Cansada
AltoPreco	Alto preço
Amigo	Amigo
AmigosCelestiais	Amigos celestiais
AMinhaOferta	A Minha Oferta
AmorDePai	Amor de Pai
AndamProcurandoCristoMeuMestre	Andam procurando + Cristo, meu mestre
AoMeuRedor	Ao Meu Redor
AoOlharPraCruz	Ao Olhar Pra Cruz
AoQueEDigno	Ao que é digno
AoUnico	Ao único
AqueleQueEstaComCristoReinaHoje	Aquele que está com Cristo + Reina hoje
AqueleQueHabitaEleEOLeao	Aquele que habita + Ele é o leão
AquiNaoEMeuLar	Aqui não é meu lar
AquiViemosTeAdorar	Aqui viemos te adorar
ARocha	A Rocha
AteOFimDoMundo	Até o Fim do Mundo
AteOsConfinsDaTerra	Até Os Confins da Terra
AteQueEleVenha	Até Que Ele Venha
ATerraVaiUmDiaContemplar	A terra vai um dia contemplar
ATiSenhorElevoAMinhalma	A Ti, Senhor, elevo a minh’alma
AtraiMeuCoracao	Atrai Meu Coração
ATuaGloria	A Tua Glória
AutoridadeEPoder	Autoridade e poder
AVitoria	A Vitória
BemAventurado	Bem aventurado
BemQuerer	Bem Querer
BemVindoAFamilia	Bem vindo à Família
BencaoApostolicaMaiorDasAlegrias	Bênção apostólica + Maior das alegrias
BencaoSobreBencao	Bênção sobre bênção
BendizeOMinhalma	Bendize, ó minh’alma
BomEstarmosAqui	Bom estarmos aqui
BondadeDeDeus	Bondade de Deus
BrilhaJesus	Brilha, Jesus
BuscaiPrimeiro	Buscai primeiro
CalmoSerenoETranquilo	Calmo, sereno e tranquilo
CaminhoNoDeserto	Caminho No Deserto
CancaoCancao	Canção, canção
CancaoDoApocalipse	Canção do Apocalipse
CancaoDoEspirito	Canção do Espírito
Cantai	Cantai
CantaiAoSenhor	Cantai ao Senhor
CantareiTeuAmorPraSempre	Cantarei Teu Amor Pra Sempre
CanteACriacao	Cante a Criação
CanteAoSenhor	Cante Ao Senhor
CantoDeVitoria	Canto de Vitória
CelebraiACristoCelebrai	Celebrai a Cristo, Celebrai!
CelebraiComJubiloAoSenhor	Celebrai com júbilo ao Senhor
CelebreAoRei	Celebre Ao Rei
CemOvelhas	Cem Ovelhas
CeusETerra	Céus e terra
ClamoATi	Clamo a Ti
ComoACorca	Como a Corça
Comunhao	Comunhão
Conhecerei	Conhecerei
Consagracao	Consagração
ConstrangidosPeloAmor	Constrangidos pelo amor
CoracaoDaNoiva	Coração da Noiva
CoracaoIgualAoTeu	Coração igual ao teu
CordeiroSanto	Cordeiro Santo
CorpoEFamilia	Corpo e família
CristoAmouAMimEATi	Cristo Amou a Mim e a Ti
CristoJesus	Cristo Jesus
CristoMeuMestre	Cristo, meu mestre
DameODeus	Dá-me, Ó Deus
Declaramos	Declaramos
DeixaQueimar	Deixa queimar
DerramaTuaShekinaDoceETeuAmor	Derrama Tua Shekiná + Doce é teu amor
Descansarei	Descansarei
DesdeOsConfinsDaTerra	Desde Os Confins da Terra
Desperta	Desperta
DeTodasAsTribos	De todas as tribos
DeusDaMinhaVida	Deus da Minha Vida
DeusDePromessas	Deus de promessas
DeusEDeus	Deus É Deus
DeusEFiel	Deus é fiel
DeusEstaAqui	Deus Está Aqui
DeusEterno	Deus Eterno
DeusForte	Deus Forte
DeusMeAma	Deus me Ama
DeusSupremo	Deus supremo
Devocao	Devoção
DiaDeGloria	Dia de glória
DianteDaCruz	Diante da Cruz
DianteDele	Diante dEle
DianteDeTi	Diante de Ti
DignoDeGloria	Digno de glória
DignoEOSenhor	Digno É o Senhor
DivinoCompanheiro	Divino companheiro
DoceEspirito	Doce Espírito
DoceETeuAmor	Doce É Teu Amor
DoceNome	Doce nome
DonoDoMeuCoracao	Dono do Meu Coração
EAUncaoDeDeus	É a Unção de Deus
EismeAquiSenhor	Eis-me aqui, Senhor
EleEContigo	Ele é contigo
EleEExaltado	Ele é exaltado
EleEOLeao	Ele é o leão
Emaus	Emaús
EmNomeDoSenhorJesus	Em nome do Senhor Jesus
EmTeusBracos	Em Teus Braços
EnquantoEuCalei	Enquanto eu calei
EnquantoOramos	Enquanto oramos
EntaoSeVera	Então se verá
EspiritoEncheComoACorca	Espírito Enche + Como a corça
EstaPaz	Esta Paz
EsteEONossoDeus	Este é o nosso Deus
EstrelaDaManha	Estrela da manhã
ETudoSobreVoce	É Tudo Sobre Você
EuCreioEmJesus	Eu creio em Jesus
EuEMinhaCasa	Eu e Minha Casa
EuEscolhoDeus	Eu Escolho Deus
EuMeRendo	Eu Me Rendo
EuNasciDeNovo	Eu Nasci de Novo
EuNavegarei	Eu Navegarei
EuPrecisoDeTi	Eu Preciso de Ti
EuQueroSerUmaBencao	Eu quero ser uma bênção
EuTeAgradeco	Eu Te agradeço
EuTeLouvarei	Eu te louvarei
EuTenhoUmaCasa	Eu Tenho Uma Casa
EuTeQuero	Eu Te Quero
EuVivoParaOTeuLouvor	Eu Vivo Para o Teu Louvor
EuVouConstruir	Eu Vou Construir
ExaltamosTeuNome	Exaltamos teu nome
Exaltarteei	Exaltar-te-ei
Familia	Família
FazChover	Faz chover
FazChover	Faz chover
FazUmMilagreEmMim	Faz Um Milagre Em Mim
FicoFeliz	Fico Feliz
FilhoDoDeusVivo	Filho do Deus Vivo
FoiAssim	Foi assim
FoiNoCalvario	Foi no Calvário
ForcaESabedoria	Força e Sabedoria
FormosoEs	Formoso és
GalhosSecos	Galhos secos
Galileu	Galileu
Genesis	Gênesis
GeracaoQueDanca	Geração que dança
GloriaTeDareiAGloria	Glória, Te Darei a Glória
Graca	Graça
GracasDou	Graças Dou
GrandeDeus	Grande Deus
GrandeEOSenhor	Grande é o Senhor
GrandeEOSenhor	Grande é o Senhor
GrandiosoDeus	Grandioso Deus
HaMomentos	Há momentos
HaUmaUncao	Há uma unção
Hosana	Hosana
Hosana	Hosana
IdeEPregai	Ide e pregai
Igreja	Igreja
IgrejaPresente	Igreja Presente
Incomparavel	Incomparável
Isaias	Isaías 53
Isaias	Isaías 9
JeovaEOTeuCavaleiro	Jeová é o teu Cavaleiro
Jerico	Jericó
JesusCristoMudouMeuViver	Jesus Cristo mudou meu viver
JesusEmBreveDoCeuVira	Jesus em breve do céu virá
JesusEMelhor	Jesus É Melhor
JesusEmTuaPresenca	Jesus, em tua presença
JesusEsOMeuAmado	Jesus, És o Meu Amado
JesusVoceMeLibertou	Jesus, você Me Libertou
LanceSuaRede	Lance Sua Rede
LeaoDeJuda	Leão de Judá
LouvadoSeja	Louvado Seja
LouvemosAoSenhor	Louvemos ao Senhor
LugarSecreto	Lugar Secreto
MadeiroLavrado	Madeiro Lavrado
MaiorDasAlegrias	Maior das alegrias
MaiorEJesus	Maior é Jesus
MaiorEOQueEstaEmNos	Maior é o que está em nós
MaisDoQueAVida	Mais do que a vida
MaisQueTudo	Mais Que Tudo
MaisQueUmAmigo	Mais Que Um Amigo
MaisQueUmaVoz	Mais Que Uma Voz
MaosDoOleiro	Mãos do Oleiro
Maranata	Maranata
Maranata	Maranata
Maravilhado	Maravilhado
MaravilhosaGraca	Maravilhosa graça
Maravilhoso	Maravilhoso
MarcaDeCristo	Marca de Cristo
Marcharemos	Marcharemos
MeAma	Me ama
MeDerramar	Me derramar
MeLevaOndeEuPossaOuvir	Me leva onde eu possa ouvir
MeRendoATi	Me Rendo a Ti
MeuAmadoIrmao	Meu amado irmão
MeuAmigoSejaBemVindoQuaoBom	Meu amigo, seja bem vindo + Quão bom
MeuCoracao	Meu coração
MeuCoracaoTePertence	Meu coração te pertence
MeuMelhorAmigo	Meu melhor amigo
MeuMestre	Meu mestre
MeuPrazer	Meu prazer
MeuRefugio	Meu Refúgio
Milagre	Milagre
NadaAlemDoSangue	Nada Além do Sangue
NaoANosSenhor	Não a nós, Senhor
NaoHaDeusMaior	Não há Deus maior
NaoVouFicarSozinho	Não vou ficar sozinho
NinguemSoJesus	Ninguém, só Jesus
NinguemSoTu	Ninguém, só tu
NoControleTuEstas	No controle Tu estás
NomeSobreTodoNome	Nome Sobre Todo Nome
NosBracosDoMeuPai	Nos Braços do Meu Pai
NosClamamosweCryOut	Nós clamamos (we cry out)
NossoDeusESoberano	Nosso Deus é soberano
NossoTremendoDeus	Nosso Tremendo Deus
NovaCriatura	Nova criatura
NovaVida	Nova Vida
ObrigadoJesus	Obrigado Jesus
Oceanos	Oceanos
OCeuJaSeAclarou	O Céu Já Se Aclarou
OCheiroDasAguas	O Cheiro Das Águas
OeuSou	O “EU SOU”
OfertaAgradavelATi	Oferta Agradável a Ti
OfertaDeAmor	Oferta de amor
OGrito	O Grito
OhQueDesfruteCristoDaAMim	Oh! Que desfrute Cristo dá a mim
OIdeEComigoEVoce	O ide é comigo e você
OleoDeAlegria	Óleo de Alegria
OLouvaiADeusComigo	Ó, louvai a Deus comigo
OMarSeAbrira	O Mar Se Abrirá
ONomeDeJesus	O Nome de Jesus
ONossoGeneralECristo	O nosso general é Cristo
OPoderDoTeuAmor	O Poder do Teu Amor
Oracao	Oração
OSantoEspirito	Ó SANTO ESPÍRITO
OSenhorDeusEstaNoMeioDeTi	O Senhor Deus está no meio de ti
OSenhorEALuz	O Senhor é a Luz
OSenhorReinaEmSeuPovo	O Senhor reina em seu povo
OusadoAmor	Ousado Amor
PaiAbreOMeuCoracao	Pai Abre o Meu Coração
PaiDeAmor	Pai de Amor
ParabensPraVoce	Parabéns pra você
ParecidoContigo	Parecido Contigo
PassoAPasso	Passo a passo
Perdao	Perdão
PerdaoEGraca	Perdão e Graça
PertoDeMimhereInMyLife	Perto de Mim (Here In My Life)
Pisaduras	Pisaduras
PiseNasAguas	Pise nas águas
PlanoMelhor	Plano Melhor
PoderosoDeus	Poderoso Deus
PoderPraSalvar	Poder pra Salvar
PoesiasDeAmor	Poesias de Amor
PorAmor	Por amor
PorAmor	Por Amor
PorqueEleVive	Porque Ele vive
PorQuemTuEs	Por Quem Tú És
PovoLivre	Povo livre
PraOndeEuIrei	Pra onde eu irei
PrecisoDeTi	Preciso de Ti
Presenca	Presença
Promessas	Promessas
Purificame	Purifica-me
QuandoJesusEstendeuASuaMao	Quando Jesus Estendeu a Sua Mão
QuantoMaisOSirvo	Quanto mais o sirvo
QuaoBom	Quão bom
QuaoGrandeEOMeuDeus	Quão Grande É O Meu Deus
QuaoLindoEsseNomeE	Quão lindo esse nome é
QueAmorEEsse	Que Amor É Esse
QueAPazDeDeusReine	Que a Paz de Deus Reine
QueBomSera	Que bom será
Quebrantado	Quebrantado
QuemDaAPaz	Quem dá a paz
QuemDizesQueEuSou	Quem Dizes Que Eu Sou
QuemEDeusAcimaDoSenhor	Quem é Deus acima do Senhor
QuemPodeLivrar	Quem pode livrar
QuemSouEu	Quem Sou Eu
QueroEstar	Quero estar
QueroLouvarte	Quero Louvar-te
QueroSubir	Quero Subir
QueroTeObedecer	Quero Te Obedecer
Recomecar	Recomeçar
RedeAoMar	Rede ao mar
Redencao	Redenção
ReiDasNacoes	Rei das Nações
ReiDeMajestade	Rei de Majestade
ReiDosReis	Rei dos reis
Reina	Reina
ReinaEmMim	Reina em Mim
ReinaHoje	Reina hoje
ReinaOPoderosoDeus	Reina o Poderoso Deus
RendeiGracas	Rendei graças
Renovame	Renova-me
Ressuscitou	Ressuscitou
RioDeVida	Rio de Vida
RompendoEmFe	Rompendo em fé
SacrificiosDeLouvor	Sacrifícios de Louvor
SalmosDeLouvor	Salmos de louvor
SalvoPelaGraca	Salvo Pela Graça
SantoEspirito	Santo Espírito
SantoEUngido	Santo e ungido
SantoLugar	Santo Lugar
Satisfacao	Satisfação
SeConfessarmos	Se confessarmos
SeEuMeHumilhar	Se eu me humilhar
SeExaltado	Sê exaltado
Seguranca	Segurança
SejaEngrandecido	Seja engrandecido
SejaOCentro	Seja o Centro
SemCessar	Sem cessar
SeNaoForPraTeAdorar	Se não for pra te adorar
SenhorDeTudo	Senhor de Tudo
SenhorDoUniverso	Senhor do Universo
SenhorERei	Senhor e Rei
SenhorLevame	Senhor, Leva-me
SenhorTeQuero	Senhor, Te Quero
Shalom	Shalom
Sinceramente	Sinceramente
SomosJovensCrentes	Somos jovens crentes
SomosUm	Somos Um
SondameUsame	Sonda-me, usa-me
SoproDeDeus	Sopro de Deus
SoTuEsSantoUmaCoisaDeixaQueimar	Só Tu És Santo + Uma coisa + Deixa queimar
SouUmNovoSer	Sou um novo ser
SuperabundanteGraca	Superabundante Graça
TalEAPaz	Tal é a paz
TeAgradeco	Te Agradeço
TeAgradecoOhPai	Te agradeço, oh Pai
TeConhecer	Te conhecer
TeExaltamos	Te exaltamos
TeLouvarei	Te louvarei
TempestadeDaGracagraciousTempest	Tempestade da Graça (gracious Tempest)
TempoDeDeus	Tempo de Deus
TempoDeFesta	Tempo de Festa
TerraFertil	Terra Fértil
TeuAmorEIncrivel	Teu Amor É Incrível
TeuAmorNaoFalha	Teu amor não falha
TeuNomeESanto	Teu Nome é Santo
TeuSantoNome	Teu Santo Nome
TeusOlhos	Teus Olhos
TimeDeDeus	Time de Deus
Tocoume	Tocou-me
TomaOMeuCoracao	Toma o Meu Coração
TomaTodoMeuSer	Toma Todo Meu Ser
Transfiguracao	Transfiguração
TributaiAoSenhor	Tributai ao Senhor
TributoAIehovah	Tributo a Iehovah
TronoDeLouvor	Trono de louvor
TuaGraca	Tua graça
TuaGracaMeBasta	Tua Graça Me Basta
TuaGracaMeBasta	Tua Graça Me Basta
TuaVoz	Tua Voz
TudoAVerComEle	Tudo a Ver Com Ele
TudoEDiferente	Tudo É Diferente
TudoEntregoATi	Tudo Entrego a Ti
TudoETeu	Tudo é Teu
TudoNovo	Tudo Novo
TudoOQueSou	Tudo o Que Sou
TuEsBom	Tu és Bom
TuEsBom	Tu és Bom
TuEsDignoDoMeuLouvor	Tu És Digno do Meu Louvor
TuEsORei	Tu És o Rei
TuEsSantoprincipeDaPaz	Tu és santo (príncipe da paz)
TuEsSoberano	Tu és soberano
TuMeFazFelizmadeMeGlad	Tu Me Faz Feliz (Made Me Glad)
TuSomenteEsDeus	Tu Somente És Deus
UmaCoisa	Uma coisa
UmaCoisaPecoAoSenhor	Uma Coisa Peço Ao Senhor
UnicoCaminho	Único Caminho
ValorDeUmaAlma	Valor de Uma Alma
VamosAdorarADeus	Vamos adorar a Deus
VasoNovo	Vaso novo
VasosQuebrados	Vasos Quebrados
VejoQueAVitoria	Vejo que a Vitória
VemEstaEAHora	Vem, esta é a hora
VemLouvar	Vem louvar
VerdadeiroAdorador	Verdadeiro Adorador
VesteAArmadura	Veste a Armadura
VidaEmAbundancia	Vida em Abundância
VimParaAdorarte	Vim para adorar-te
VimTeBuscar	Vim te buscar
Viras	Virás
VivendoEmComunhao	Vivendo Em Comunhão
VoceMereceyouDeserve	Você Merece (You Deserve)
VouParaOLar	Vou para o lar
VouSeguirComFe	Vou seguir com fé